H 21 W 35
11111111111111111111111111111111111
10000000000000000000000000000000001
10000000000000000000000000000000001
10000000000000000000000000000000001
10001110000000000100000000001110001
10001110000000001110000000001110001
10001110000000000100000000001110001
10000001000000000000000000010000001
10000000100000000000000000100000001
10000000000000000000000000000000001
10000000000000000000000000000000001
10000000000000000000000000000000001
10000000100000000000000000100000001
10000001000000000000000000010000001
10001110000000000100000000001110001
10001110000000001110000000001110001
10001110000000000100000000001110001
10000000000000000000000000000000001
10000000000000000000000000000000001
10000000000000000000000000000000001
11111111111111111111111111111111111